+++++++++++++++++
+N O P Q R S T U+
+               +
+M             V+
+               +
+L      0      W+
+     abcde     +
+     fghij     +
+K    klmno    X+
+     pqrst     +
+     uvwxy     +
+J      z      Y+
+               +
+I             Z+
+               +
+H G F E D C B A+
+++++++++++++++++

